##############################
#       #         #          #
#       #         #          #
#       #                    #
#                            #
#                            #
#########         #          #
#             #####          #
#             #              #
#             #              #
#             #              #
#             #              # 
############################## 
