####################################
#                                  #
#                                  #
#                                  #
#                                  #
#                                  #
#                                  #
#                                  #    
#                                  #
#                                  #
#                                  #
#                                  #
#                                  #
#                                  #
#                                  #
####################################